----------
----------
----11----
---1111---
--111111--
--11--11--
-11111111-
----11----