1123412341
--44--44--
----33----
--22--22--
-11111111-
---1111---
--111111--
----11----